Main   800
B   900
C   1100
D   1300
E   1500
F   1800
G   2300