Main   800
B   1200
C   1300
D   1900
E   2500
F   3100