A   800
B   1300
C   1400
D   1900
E   2200
F   2700