A   800
B   800
C   1400
D   2100
E   2300
F   2800
G   2900
H   3500