Main   800
B   1000
C   1600
D   2000
E   2200
F   2700