Main   800
B   1100
C   1400
D   1700
E   2200
F   2400